b a k f u
b a n f i
b a s n a
b e n d e
b e v r i
b i k l a
b i l m a
b l o t i
b r a p u
b u m r u
b u n r e
ʃ a ʃ r a
ʃ a x n o
ʃ e n b a
ʃ e n s a
ʃ i l m o
ʃ i l t a
ʃ i n d u
ʃ i n ʒ e
ʃ i n t a
ʃ k e ʒ i
ʃ l u p a
ʃ m i l a
ʃ m i m a
ʃ n i s a
ʃ t i t a
ʃ o r t u
ʃ r a d i
ʃ r i b e
ʃ k e k i
ʃ u k l a
ʃ u m k i
ʃ u p r a
d a m r i
d a n t i
d e k p u
d i ʃ r a
d i k n i
d i n ʒ u
d u n d a
d oi̯ p i
f a n r i
f a t r i
f e n d i
f e n s o
f i l s o
f i n t i
f l a l u
f l a n i
f l i b a
f l i r a
f o n m o
f r a s o
f r u m u
f u k p i
f u l t a
ɡ a l f i
ɡ a n z u
ɡ a s n u
ɡ e n ʒ a
ɡ e n x u
ɡ i n k a
ɡ u s n i
ʒ a l n a
ʒ a n t a
ʒ a s p u
ʒ a t n a
ʒ b e r a
ʒ b i n i
ʒ d a r i
ʒ d i n i
ʒ ɡ a r i
ʒ ɡ i r a
ʒ i ʒ n u
ʒ i l k a
ʒ i l r a
ʒ i n m e
ʒ i n v i
ʒ i r n a
ʒ i t f a
ʒ i v b u
ʒ u h u
ʒ u l n e
ʒ u n ɡ o
k a k p a
k a l t e
k a n p e
k a n t u
k a n x e
k a r d a
k a v b u
k e t ʃ o
k l u p e
k o b l i
k o r b i
k r i n u
k r i x a
k u ʒ ʃ e
k u n r a
l a d r u
l a k n e
l a m ʒ i
l a n ʃ i
l a n l i
l i t k i
m a n r i
m a p n i
m a r ɡ u
m a v ʒ i
m a x r i
m i n l i
m i n r a
m i p r i
m i r l i
m i x r e
m l e d i
m o l r o
m o r k o
m u ʃ t i
n a l ʃ i
n a n ʃ a
n a n v i
n a v n i
n i b l i
n u k n i
p a l k u
p a n ʃ i
p a n z i
p a t x u
p e z l i
p i l ʒ i
p i n d i
p l i x a
p o l n o
p r u n i
r a l ʒ u
r a n ɡ o
r a n s u
r e n v i
r e s p a
r i n ʒ u
r i n k a
r i r n i
r i r x e
r i s n a
r o m ɡ e
r o t s u
s a k t a
s a n ʒ i
s a s k e
s e f t a
s e l ʃ i
s f a n i
s i d b o
s i n m a
s i s t i
s l i r i
s l u n i
s m a d i
s o d v a
s o m a i
s p a l i
s r a k u
s r a l o
s r a s u
s r i t o
s t a ʃ e
s t o d i
s u ʃ t a
s u m n e
t a m n e
t a n b o
t a p l a
t a r ʃ i
t a t p i
t i v n i
t o k n u
t u ʒ l i
t u n l o
t u r n i
t u t r a
v a l s i
v a s s u
v i b n a
v i n d u
v l a ʃ u
v l i l e
v o m a i
x a d b a
x a l b o
x a s l i
x r a n i
x u k m i
x ə
z a l v i
z b a b u
z b a n i
z i f r e
z m a d u
z u n t i
